WWWWWWWWWWWWWWWWWWWWWWWWWWWWWWWWWWWWWWWWWWWWWWWWWWWWWWWWW
W.......................................................W
W.W.W.W.W.W.W.WBW.W.W.W.W.W.W.W.W.W.W.W.W.W.W.W.W.W.W.W.W
W..............B.........O..............................W
W.W.W.W.W.W.W.WBW.W.W.W.W.W.W.W.W.W.W.W.W.W.W.W.W.W.W.W.W
W........................E..............................W
W.W.W.W.W.W.W.W.W.W.W.W.W.W.W.W.W.W.W.W.W.W.W.W.W.W.W.W.W
W.......................................................W
W.W.W.W.W.W.W.W.W.W.W.W.W.W.W.W.W.W.W.W.W.W.W.W.W.W.W.W.W
W......P.............D..................................W
W.W.W.W.W.W.W.W.W.W.W.W.W.W.W.W.W.W.W.W.W.W.W.W.W.W.W.W.W
W.......................................................W
WWWWWWWWWWWWWWWWWWWWWWWWWWWWWWWWWWWWWWWWWWWWWWWWWWWWWWWWW