WWWWWWWWWWWWWWWWWWWWWWWWWWWWWWWWWWWWWWWWWWWW
W..........................................W
W..........................................W
W..........................................W
W..........................................W
W....P.....................................W
W..........................................W
W..........................................W
W..........................................W
W..........................................W
W..........................................W
W..........................................W
W..........................................W
W..........................................W
W..........................................W
W..........................................W
W..........................................W
W..........................................W
W..........................................W
W..........................................W
W..........................................W
W..........................................W
W..........................................W
W..........................................W
W..........................................W
W..........................................W
W..........................................W
W..........................................W
W..........................................W
WWWWWWWWWWWWWWWWWWWWWWWWWWWWWWWWWWWWWWWWWWWW
