WWWWWWWWWW
W........W
W..P.....W
W........W
WWWWWWWWWW
